F 200,0,200
C 99,99,99



NO ../texters/pa.xpm
SO ../texters/bbbbb.xpm
EA ../texters/img0.xpm
WE ../texters/pa.xpm
DO ../texters/rock-wall-kevin-croitz.xpm

111111111111111111111111111
100000000000000111110111111
111111100000000111110111111
1111100D000D000000000000001
1111111N0D00110111111111111
111111111111111111111111111
